1111111111111111111111111111
100C000000C001000000000C0001
1101111111000000C000E0000001
11100100000CC000000000000011
10000100000000C0000000C11111
10C011000000011111CCC1110001
10001C0000001000000000000001
10111C0000001000000000000001
10000C0000001000000000000001
10001C0000001000000000000001
10001C0000001000000000000001
100C100P0CC000000100CC000011
1111111111111111111111111111